sno	CandidateName	Party_Name	EVM Votes	Postal Votes	Total Votes	%Votes	constuency
1	NEEL DAMAN KHATRI	Bharatiya Janata Party	68244	589	68833	41.54	NARELA
2	MAHENDER CHAUDHARY	Bahujan Samaj Party	811	10	821	0.5	NARELA
3	SHARAD KUMAR	Aam Aadmi Party	86070	192	86262	52.06	NARELA
4	SIDDHARTH KUNDU	Indian National Congress	6240	30	6270	3.78	NARELA
5	CHAND RAM	Rastriya Aam Jan Seva Party	138	0	138	0.08	NARELA
6	NAR SINGH	Sarvajan Hitay Party	603	1	604	0.36	NARELA
7	RAMESH KUMAR	Bhartiya Samajik Nyay Party	104	1	105	0.06	NARELA
8	RAJBALA SAINI	Loktanter Suraksha Party	1077	5	1082	0.65	NARELA
9	SURESH KUMAR	Peoples Party of India (Democratic)	180	0	180	0.11	NARELA
10	SULESH KUMAR	Aapki Apni Party (Peoples)	495	0	495	0.3	NARELA
11	ADITI	Independent	151	0	151	0.09	NARELA
12	NOTA	None of the Above	746	7	753	0.45	NARELA
1	GANGA RAM	Bahujan Samaj Party	1857	12	1869	0.84	BURARI
2	SANJEEV JHA	Aam Aadmi Party	139368	230	139598	62.81	BURARI
3	ANIL KUMAR YADAV	Bhartiya Samajik Nyay Party	1206	4	1210	0.54	BURARI
4	AMARJEET KUMAR	SOCIALIST UNITY CENTRE OF INDIA (COMMUNIST)	653	1	654	0.29	BURARI
5	ARVIND MISHRA	Hindusthan Nirman Dal	285	0	285	0.13	BURARI
6	AWDESH VERMA ALIAS AVDHESH VERMA	Jan Adhikar Party	281	1	282	0.13	BURARI
7	USHA GAUTAM	Rashtriya Aikta Manch Party	180	0	180	0.08	BURARI
8	KRISHNA MOHAN JHA	Aam Aadmi Sangharsh Party (S)	182	1	183	0.08	BURARI
9	GULAB SINGHAL	Rashtriya Janshakti Party (Secular)	146	0	146	0.07	BURARI
10	DINESH KUMAR MISHRA	Rashtriya Samaj Paksha	164	1	165	0.07	BURARI
11	DEEPAK GUPTA	Rashtriya Lok Dal	671	5	676	0.3	BURARI
12	DHARAM VEER	Shiv Sena	18022	22	18044	8.12	BURARI
13	PANKAJ KUMAR AGRAWAL	Republican Party of India (Athawale)	287	0	287	0.13	BURARI
14	PRAMOD TYAGI	Rashtriya Janata Dal	2262	16	2278	1.02	BURARI
15	MANOJ RAI	Aapki Apni Party (Peoples)	805	1	806	0.36	BURARI
16	MONU	Bhartiya Rashtrawadi Party	347	0	347	0.16	BURARI
17	RANJEET SINGH	Uttarakhand Kranti Dal	1239	5	1244	0.56	BURARI
18	RAM SUSHIL MISHRA	Satya Bahumat Party	456	0	456	0.21	BURARI
19	SHIV NARAYAN SINGH	Peoples Party of India (Democratic)	382	0	382	0.17	BURARI
20	SHAILENDRA KUMAR	Janata Dal (United)	50941	499	51440	23.14	BURARI
21	AAZAD NAFE SINGH RAJPUT	Independent	227	0	227	0.1	BURARI
22	SHAILENDRA SINGH PARIHAR	Independent	289	2	291	0.13	BURARI
23	NOTA	None of the Above	1198	8	1206	0.54	BURARI
1	AMAR LATA SANGWAN	Indian National Congress	3085	17	3102	2.5	TIMARPUR
2	ADVOCATE UMA SHANKER GAUTAM	Bahujan Samaj Party	305	1	306	0.25	TIMARPUR
3	DILIP PANDEY	Aam Aadmi Party	71345	87	71432	57.6	TIMARPUR
4	SURINDER PAL SINGH (BITTOO)	Bharatiya Janata Party	47136	152	47288	38.13	TIMARPUR
5	SANJEEV KUMAR RANA	Communist Party of India	245	0	245	0.2	TIMARPUR
6	AMITA MALIK	Akhil Bharatiya Jan Shakti Party	88	0	88	0.07	TIMARPUR
7	KAVITA	Bhartiya Samajik Nyay Party	80	0	80	0.06	TIMARPUR
8	JAGANNATH	Bhartiya Janta Dal (Integrated)	53	0	53	0.04	TIMARPUR
9	PARASHU RAM MAURYA	Jan Adhikar Party	84	0	84	0.07	TIMARPUR
10	YUGAL KISHOR PODDAR	Rashtravadi Janata Party	34	0	34	0.03	TIMARPUR
11	RAJ KUMAR MALIK	Satya Bahumat Party	62	0	62	0.05	TIMARPUR
12	VISHAL GHANSHAM GHOBALE	Tipu Sultan Party	129	0	129	0.1	TIMARPUR
13	SONU KAUSHIK	Aapki Apni Party (Peoples)	495	0	495	0.4	TIMARPUR
14	HEMRAJ	Peoples Party of India (Democratic)	105	0	105	0.08	TIMARPUR
15	NOTA	None of the Above	507	1	508	0.41	TIMARPUR
1	CHANDER PAL	Bahujan Samaj Party	530	2	532	0.51	ADARSH NAGAR
2	PAWAN SHARMA	Aam Aadmi Party	46808	84	46892	45.2	ADARSH NAGAR
3	MUKESH KUMAR GOEL	Indian National Congress	9986	28	10014	9.65	ADARSH NAGAR
4	RAJ KUMAR BHATIA	Bharatiya Janata Party	45066	237	45303	43.66	ADARSH NAGAR
5	KAILASH	Aapki Apni Party (Peoples)	302	0	302	0.29	ADARSH NAGAR
6	VIJAY KR AGGARWAL	Independent	163	1	164	0.16	ADARSH NAGAR
7	SHASHI	Independent	125	1	126	0.12	ADARSH NAGAR
8	NOTA	None of the Above	417	2	419	0.4	ADARSH NAGAR
1	AJESH YADAV	Aam Aadmi Party	69357	0	69357	49.67	BADLI
2	DEVENDER YADAV	Indian National Congress	27449	0	27449	19.66	BADLI
3	LAXMAN KUMAR	Bahujan Samaj Party	579	0	579	0.41	BADLI
4	VIJAY KUMAR BHAGAT	Bharatiya Janata Party	40234	0	40234	28.81	BADLI
5	UMA DUTT SHARMA	Rashtriya Aikta Manch Party	212	0	212	0.15	BADLI
6	NARENDRA PAL SINGH	Rashtriya Samaj Paksha	125	0	125	0.09	BADLI
7	PRADEEP KUMAR	Satya Bahumat Party	46	0	46	0.03	BADLI
8	MULAYAM SINGH	Akhil Bharatiya Jan Shakti Party	143	0	143	0.1	BADLI
9	VIJAY KUMAR	Aapki Apni Party (Peoples)	246	0	246	0.18	BADLI
10	JAI PAL	Independent	83	0	83	0.06	BADLI
11	DEVENDER SINGH YADAV	Independent	129	0	129	0.09	BADLI
12	VIKASH KUMAR	Independent	151	0	151	0.11	BADLI
13	SIDDHARTH NAIR	Independent	276	0	276	0.2	BADLI
14	NOTA	None of the Above	608	0	608	0.44	BADLI
1	PRADEEP KUMAR PANDEY	Indian National Congress	2634	17	2651	1.59	RITHALA
2	MANISH CHAUDHARY	Bharatiya Janata Party	73813	254	74067	44.33	RITHALA
3	MOHINDER GOYAL	Aam Aadmi Party	87807	133	87940	52.63	RITHALA
4	RAJESH KUMAR	Bahujan Samaj Party	487	4	491	0.29	RITHALA
5	JANAB MULLA	Asankhya Samaj Party	50	0	50	0.03	RITHALA
6	WAHEED KHAN	Tipu Sultan Party	53	0	53	0.03	RITHALA
7	VIJAY KUMAR	Rashtra Nirman Party	57	0	57	0.03	RITHALA
8	SHIV NANDAN SINGH	Bharatiya Sampuran Krantikari Party	188	0	188	0.11	RITHALA
9	SURAJ SINGH	Akhil Bharatiya Jan Shakti Party	82	0	82	0.05	RITHALA
10	ALOK DIXIT	Independent	272	0	272	0.16	RITHALA
11	VIDYA PATI	Independent	232	0	232	0.14	RITHALA
12	TRIBENI PRASAD	Independent	172	0	172	0.1	RITHALA
13	NOTA	None of the Above	821	3	824	0.49	RITHALA
1	ABHIPSA CHAUHAN	Communist Party of India	1227	0	1227	0.62	BAWANA(SC)
2	JAI BHAGWAN	Aam Aadmi Party	95455	260	95715	48.38	BAWANA(SC)
3	RAVINDER KUMAR	Bharatiya Janata Party	83456	733	84189	42.55	BAWANA(SC)
4	RANJIT RAM	Bahujan Samaj Party	1931	10	1941	0.98	BAWANA(SC)
5	SURENDER KUMAR	Indian National Congress	12716	87	12803	6.47	BAWANA(SC)
6	PRADEEP	Aapki Apni Party (Peoples)	919	2	921	0.47	BAWANA(SC)
7	NOTA	None of the Above	1031	15	1046	0.53	BAWANA(SC)
1	AZAD SINGH	Bharatiya Janata Party	70855	280	71135	42.37	MUNDKA
2	DHARAMPAL LAKRA	Aam Aadmi Party	90194	99	90293	53.78	MUNDKA
3	NARESH KUMAR	Indian National Congress	5073	9	5082	3.03	MUNDKA
4	KARAM CHAND LATHWAL	Bhartiya Pragatisheel Congress	218	1	219	0.13	MUNDKA
5	CHETRAM	Satya Bahumat Party	273	0	273	0.16	MUNDKA
6	NOTA	None of the Above	898	5	903	0.54	MUNDKA
1	ANIL JHA	Bharatiya Janata Party	80551	107	80658	46.51	KIRARI
2	RITURAJ GOVIND	Aam Aadmi Party	86255	57	86312	49.77	KIRARI
3	RABINDRA KUMAR SINGH	Bahujan Samaj Party	1554	3	1557	0.9	KIRARI
4	AJIT KUMAR	Lok Jan Shakti Party	121	0	121	0.07	KIRARI
5	RAKESH KUMAR	Satya Bahumat Party	85	0	85	0.05	KIRARI
6	MD RIYAZUDDIN KHAN	Rashtriya Janata Dal	255	1	256	0.15	KIRARI
7	SHAWKAT ALI ANSARI	Asankhya Samaj Party	103	0	103	0.06	KIRARI
8	KAUSHAL MISHRA	Independent	1830	0	1830	1.06	KIRARI
9	PRAHLAD MAURYA	Independent	206	0	206	0.12	KIRARI
10	RAVINDER KUMAR	Independent	721	0	721	0.42	KIRARI
11	REKHA BHARTI	Independent	512	0	512	0.3	KIRARI
12	NOTA	None of the Above	1068	3	1071	0.62	KIRARI
1	Jai Kishan	Indian National Congress	9000	33	9033	8.06	SULTANPUR MAJRA(SC)
2	Neelam	Bahujan Samaj Party	670	1	671	0.6	SULTANPUR MAJRA(SC)
3	Mukesh Kumar Ahlawat	Aam Aadmi Party	74489	84	74573	66.51	SULTANPUR MAJRA(SC)
4	Ram Chander Chawriya	Bharatiya Janata Party	26447	74	26521	23.65	SULTANPUR MAJRA(SC)
5	Bharti	Rashtravadi Janata Party	233	0	233	0.21	SULTANPUR MAJRA(SC)
6	Mahender Kumar	Sarvjan Lok Shakti Party	351	0	351	0.31	SULTANPUR MAJRA(SC)
7	Gayatri	Independent	283	0	283	0.25	SULTANPUR MAJRA(SC)
8	NOTA	None of the Above	459	1	460	0.41	SULTANPUR MAJRA(SC)
1	MANDEEP SINGH	Indian National Congress	9718	43	9761	6.45	NANGLOI JAT
2	RAGHUVINDER SHOKEEN	Aam Aadmi Party	74302	142	74444	49.21	NANGLOI JAT
3	SANDEEP	Bahujan Samaj Party	1434	4	1438	0.95	NANGLOI JAT
4	SUMAN LATA	Bharatiya Janata Party	62596	224	62820	41.53	NANGLOI JAT
5	AJEET KUMAR	Bhartiya Pragatisheel Congress	187	0	187	0.12	NANGLOI JAT
6	TARUN KUMAR KOTHARI	Vishva Shakti Party	108	0	108	0.07	NANGLOI JAT
7	DIGAMBER	Swabhiman Party	358	0	358	0.24	NANGLOI JAT
8	SAROJ BALA	Peoples Party of India (Democratic)	139	2	141	0.09	NANGLOI JAT
9	SANJEEV JOSHI	Delhi Janta Party	205	1	206	0.14	NANGLOI JAT
10	CHANDER SHEKHAR	Independent	331	1	332	0.22	NANGLOI JAT
11	RAKESH SHARMA	Independent	615	0	615	0.41	NANGLOI JAT
12	NOTA	None of the Above	849	13	862	0.57	NANGLOI JAT
1	KARAM SINGH KARMA	Bharatiya Janata Party	43914	124	44038	34.76	MANGOL PURI(SC)
2	MURARI LAL	Bahujan Samaj Party	2489	2	2491	1.97	MANGOL PURI(SC)
3	RAKHI BIRLA	Aam Aadmi Party	74046	108	74154	58.53	MANGOL PURI(SC)
4	RAJESH LILOTHIA	Indian National Congress	4056	17	4073	3.22	MANGOL PURI(SC)
5	DEEPAK KUMAR	Bhartiya Samajik Nyay Party	379	0	379	0.3	MANGOL PURI(SC)
6	VIRENDER RAY	Swaraj India	892	1	893	0.7	MANGOL PURI(SC)
7	NOTA	None of the Above	655	2	657	0.52	MANGOL PURI(SC)
1	ARUN KUMAR CHADHA	Bahujan Samaj Party	235	2	237	0.2	ROHINI
2	RAJESH NAMA BANSIWALA	Aam Aadmi Party	49405	121	49526	42.75	ROHINI
3	VIJENDER KUMAR	Bharatiya Janata Party	61804	370	62174	53.67	ROHINI
4	SUMESH GUPTA	Indian National Congress	1935	28	1963	1.69	ROHINI
5	RAJBIR	Bahujan Dravida Party	64	0	64	0.06	ROHINI
6	RAJESH GARG	Independent	974	3	977	0.84	ROHINI
7	SHEELA RANI	Independent	117	0	117	0.1	ROHINI
8	NOTA	None of the Above	777	5	782	0.68	ROHINI
1	J S NAYOL	Indian National Congress	2485	6	2491	2.13	SHALIMAR BAGH
2	BANDANA KUMARI	Aam Aadmi Party	57649	58	57707	49.41	SHALIMAR BAGH
3	MOHIT	Bahujan Samaj Party	581	0	581	0.5	SHALIMAR BAGH
4	REKHA GUPTA	Bharatiya Janata Party	54183	84	54267	46.46	SHALIMAR BAGH
5	DR. ASHWANI KUMAR	Bharat Lok Sewak Party	100	0	100	0.09	SHALIMAR BAGH
6	SAURABH GUPTA	Janhit Kisan Party	43	0	43	0.04	SHALIMAR BAGH
7	POONAM KAUSHIK	Independent	55	0	55	0.05	SHALIMAR BAGH
8	VANDANA	Independent	172	1	173	0.15	SHALIMAR BAGH
9	SHEHNAZ	Independent	119	0	119	0.1	SHALIMAR BAGH
10	SHYAM KUMAR	Independent	109	0	109	0.09	SHALIMAR BAGH
11	SHARVAN	Independent	120	0	120	0.1	SHALIMAR BAGH
12	SURESH	Independent	303	0	303	0.26	SHALIMAR BAGH
13	NOTA	None of the Above	733	2	735	0.63	SHALIMAR BAGH
1	ASHA RAM	Bahujan Samaj Party	286	3	289	0.29	SHAKUR BASTI
2	DEV RAJ ARORA	Indian National Congress	3367	15	3382	3.41	SHAKUR BASTI
3	DR. S. C. VATS	Bharatiya Janata Party	43388	185	43573	43.94	SHAKUR BASTI
4	SATYENDAR JAIN	Aam Aadmi Party	51055	110	51165	51.6	SHAKUR BASTI
5	PRAVEEN YADAV	Akhil Bharatiya Jan Shakti Party	115	0	115	0.12	SHAKUR BASTI
6	NOTA	None of the Above	638	3	641	0.65	SHAKUR BASTI
1	ARUNA	Bahujan Samaj Party	269	3	272	0.24	TRI NAGAR
2	KAMAL KANT SHARMA	Indian National Congress	4066	9	4075	3.65	TRI NAGAR
3	TILAK RAM GUPTA	Bharatiya Janata Party	47649	145	47794	42.79	TRI NAGAR
4	PREETI TOMAR	Aam Aadmi Party	58400	104	58504	52.38	TRI NAGAR
5	DEVANAND RAM	Purvanchal Mahapanchayat	156	0	156	0.14	TRI NAGAR
6	SUDHIR KUMAR	Voters Party  International	100	0	100	0.09	TRI NAGAR
7	SUBHASH	Asankhya Samaj Party	159	0	159	0.14	TRI NAGAR
8	BALJEET	Independent	121	0	121	0.11	TRI NAGAR
9	NOTA	None of the Above	514	2	516	0.46	TRI NAGAR
1	NATHU RAM	Communist Party of India  (Marxist)	139	0	139	0.13	WAZIRPUR
2	DR. MAHENDER NAGPAL	Bharatiya Janata Party	45470	171	45641	41.91	WAZIRPUR
3	MUSTQIM AHMED	Bahujan Samaj Party	888	1	889	0.82	WAZIRPUR
4	RAJESH GUPTA	Aam Aadmi Party	57276	55	57331	52.64	WAZIRPUR
5	HARIKISHAN JINDAL	Indian National Congress	3488	13	3501	3.21	WAZIRPUR
6	KAMAL KISHORE	Peoples Party of India (Democratic)	62	0	62	0.06	WAZIRPUR
7	JUGAL KISHOR CHAWLA	Rashtravadi Janata Party	38	0	38	0.03	WAZIRPUR
8	MADAN SAH	All India Forward Bloc	28	0	28	0.03	WAZIRPUR
9	VIJAY KUMAR	Akhil Bharat Hindu Mahasabha	47	0	47	0.04	WAZIRPUR
10	SURENDRA KUMAR	Aapki Apni Party (Peoples)	207	0	207	0.19	WAZIRPUR
11	NARESH KUMAR NAGPAL	Independent	70	0	70	0.06	WAZIRPUR
12	BALWANT KUMAR PARJAPATI	Independent	153	0	153	0.14	WAZIRPUR
13	RAJESH GUPTA	Independent	255	0	255	0.23	WAZIRPUR
14	SURAJ	Independent	73	0	73	0.07	WAZIRPUR
15	NOTA	None of the Above	477	0	477	0.44	WAZIRPUR
1	AKHILESH PATI TRIPATHI	Aam Aadmi Party	52594	71	52665	52.58	MODEL TOWN
2	AKANKSHA OLA	Indian National Congress	4068	17	4085	4.08	MODEL TOWN
3	KAPIL MISHRA	Bharatiya Janata Party	41357	175	41532	41.46	MODEL TOWN
4	PARMOD KUMAR SAHANI	Bahujan Samaj Party	492	0	492	0.49	MODEL TOWN
5	AMBIKA PRASAD VERMA	Satya Bahumat Party	47	0	47	0.05	MODEL TOWN
6	BABU RAM PAL	Bharatiya Sarvodaya Kranti Party	88	0	88	0.09	MODEL TOWN
7	RAJESH KUMAR TIWARI	Poorvanchal Rashtriya Congress	242	0	242	0.24	MODEL TOWN
8	VIKAS	Aapki Apni Party (Peoples)	171	0	171	0.17	MODEL TOWN
9	NOTA	None of the Above	840	1	841	0.84	MODEL TOWN
1	ASAD	Bahujan Samaj Party	573	1	574	0.46	SADAR BAZAR
2	JAI PARKASH (J.P)	Bharatiya Janata Party	43065	81	43146	34.94	SADAR BAZAR
3	SATBIR SHARMA	Indian National Congress	9833	24	9857	7.98	SADAR BAZAR
4	SOM DUTT	Aam Aadmi Party	68736	54	68790	55.71	SADAR BAZAR
5	VIRENDER KUMAR	Rashtriya Rashtrawadi Party	189	0	189	0.15	SADAR BAZAR
6	JAI PRAKASH	Independent	59	0	59	0.05	SADAR BAZAR
7	PRATAP AAMZARE	Independent	103	0	103	0.08	SADAR BAZAR
8	RAJEEV KUMAR	Independent	134	0	134	0.11	SADAR BAZAR
9	SOMDUTT s/o KRISHAN KUMAR RASTOGI	Independent	108	0	108	0.09	SADAR BAZAR
10	SOM DUTT s/o DAYA CHANDER SHARMA	Independent	110	0	110	0.09	SADAR BAZAR
11	NOTA	None of the Above	405	3	408	0.33	SADAR BAZAR
1	ALKA LAMBA	Indian National Congress	3876	5	3881	5.03	CHANDNI CHOWK
2	PARLAD SINGH SAWHNEY	Aam Aadmi Party	50845	46	50891	65.92	CHANDNI CHOWK
3	SUDESH	Bahujan Samaj Party	218	0	218	0.28	CHANDNI CHOWK
4	SUMAN KUMAR GUPTA	Bharatiya Janata Party	21260	47	21307	27.6	CHANDNI CHOWK
5	ANIL SINGH JADON	Shiv Sena	242	0	242	0.31	CHANDNI CHOWK
6	RAMESH CHAND GOYAL	Rashtravadi Janata Party	28	0	28	0.04	CHANDNI CHOWK
7	SATPAL	Asankhya Samaj Party	36	0	36	0.05	CHANDNI CHOWK
8	SADEQUE MUNIRODDIN SHAIKH	Tipu Sultan Party	27	0	27	0.03	CHANDNI CHOWK
9	KRISHNA AVTAR	Independent	29	0	29	0.04	CHANDNI CHOWK
10	VIJAY KUMAR SHARMA	Independent	62	0	62	0.08	CHANDNI CHOWK
11	VIPIN KUMAR	Independent	97	0	97	0.13	CHANDNI CHOWK
12	SANDEEP SHARMA	Independent	118	0	118	0.15	CHANDNI CHOWK
13	NOTA	None of the Above	263	0	263	0.34	CHANDNI CHOWK
1	TEJ RAM	Bahujan Samaj Party	222	1	223	0.25	MATIA MAHAL
2	MIRZA JAVED ALI	Indian National Congress	3403	6	3409	3.85	MATIA MAHAL
3	RAVINDER GUPTA	Bharatiya Janata Party	17024	17	17041	19.24	MATIA MAHAL
4	SHOAIB IQBAL	Aam Aadmi Party	67250	32	67282	75.96	MATIA MAHAL
5	ISRAR AHMED	Republican Party of India (Athawale)	173	0	173	0.2	MATIA MAHAL
6	SUHAIL MIRZA	Rashtriya Republican Party	100	0	100	0.11	MATIA MAHAL
7	MOHD. SUHAIL	Independent	49	0	49	0.06	MATIA MAHAL
8	SHOAIBUDDIN	Independent	77	0	77	0.09	MATIA MAHAL
9	NOTA	None of the Above	216	0	216	0.24	MATIA MAHAL
1	IMRAN HUSSAIN	Aam Aadmi Party	65612	32	65644	64.65	BALLIMARAN
2	DEEP CHAND	Bahujan Samaj Party	167	0	167	0.16	BALLIMARAN
3	LATA	Bharatiya Janata Party	29434	38	29472	29.03	BALLIMARAN
4	HAROON YUSUF	Indian National Congress	4797	5	4802	4.73	BALLIMARAN
5	KRISHAN KUMAR	Bhartiya Rashtriya Dal	827	0	827	0.81	BALLIMARAN
6	ZAFAR MIRZA	Rashtriya Republican Party	41	0	41	0.04	BALLIMARAN
7	SAJID ALI	Rashtriya Rashtrawadi Party	56	0	56	0.06	BALLIMARAN
8	HANSA	Peoples Party of India (Democratic)	124	0	124	0.12	BALLIMARAN
9	ARIF NABI	Independent	59	0	59	0.06	BALLIMARAN
10	NOTA	None of the Above	339	1	340	0.33	BALLIMARAN
1	GOURAV KUMAR	Indian National Congress	3365	0	3365	3.1	KAROL BAGH(SC)
2	YOGENDER CHANDOLIYA	Bharatiya Janata Party	35686	48	35734	32.95	KAROL BAGH(SC)
3	LEKHRAJ JATAV	Bahujan Samaj Party	782	1	783	0.72	KAROL BAGH(SC)
4	VISHESH RAVI	Aam Aadmi Party	67423	71	67494	62.23	KAROL BAGH(SC)
5	GAURAV	Shiv Sena	192	0	192	0.18	KAROL BAGH(SC)
6	DEEPAK KUMAR	Independent	67	0	67	0.06	KAROL BAGH(SC)
7	DHARMENDER KANWAR	Independent	171	0	171	0.16	KAROL BAGH(SC)
8	RAHUL BHARTI	Independent	106	0	106	0.1	KAROL BAGH(SC)
9	SUNIL	Independent	102	0	102	0.09	KAROL BAGH(SC)
10	NOTA	None of the Above	445	2	447	0.41	KAROL BAGH(SC)
1	KRISHNA TIRATH	Indian National Congress	3359	23	3382	2.8	PATEL NAGAR(SC)
2	PRADEEP KUMAR RAWAL	Bahujan Samaj Party	673	1	674	0.56	PATEL NAGAR(SC)
3	PRAVESH RATN	Bharatiya Janata Party	42367	161	42528	35.2	PATEL NAGAR(SC)
4	RAAJ KUMAR ANAND	Aam Aadmi Party	73341	122	73463	60.81	PATEL NAGAR(SC)
5	NOTA	None of the Above	766	1	767	0.63	PATEL NAGAR(SC)
1	NITYA NAND SINGH	Bahujan Samaj Party	581	0	581	0.52	MOTI NAGAR
2	RAMESH POPLI	Indian National Congress	3139	13	3152	2.8	MOTI NAGAR
3	SHIV CHARAN GOEL	Aam Aadmi Party	60553	69	60622	53.83	MOTI NAGAR
4	SUBHASH SACHDEVA	Bharatiya Janata Party	46412	138	46550	41.34	MOTI NAGAR
5	MD AMJAD	Rashtravadi Janata Party	171	0	171	0.15	MOTI NAGAR
6	AJIT SINGH	Independent	91	0	91	0.08	MOTI NAGAR
7	NARENDER GOEL	Independent	116	0	116	0.1	MOTI NAGAR
8	MD FAIZAN	Independent	617	0	617	0.55	MOTI NAGAR
9	SHIV CHARAN	Independent	147	0	147	0.13	MOTI NAGAR
10	NOTA	None of the Above	567	2	569	0.51	MOTI NAGAR
1	Kailash Sankla	Bharatiya Janata Party	41566	155	41721	36.26	MADIPUR(SC)
2	Girish Soni	Aam Aadmi Party	64319	121	64440	56	MADIPUR(SC)
3	Jai Prakash Panwar	Indian National Congress	6763	25	6788	5.9	MADIPUR(SC)
4	Hansraj Jaluthria	Bahujan Samaj Party	841	10	851	0.74	MADIPUR(SC)
5	Randhir Kumar	Asankhya Samaj Party	126	0	126	0.11	MADIPUR(SC)
6	Ramesh Kumar	All India Forward Bloc	84	0	84	0.07	MADIPUR(SC)
7	Sunil Meghwal	Ambedkarite Party of India	105	0	105	0.09	MADIPUR(SC)
8	Girish Prakash	Independent	221	0	221	0.19	MADIPUR(SC)
9	Manoj	Independent	218	3	221	0.19	MADIPUR(SC)
10	NOTA	None of the Above	513	4	517	0.45	MADIPUR(SC)
1	AMANDEEP SINGH SUDAN	Indian National Congress	3379	19	3398	3.04	RAJOURI GARDEN
2	A DHANWATI CHANDELA A	Aam Aadmi Party	62058	154	62212	55.7	RAJOURI GARDEN
3	RAMESH KHANNA	Bharatiya Janata Party	39087	153	39240	35.13	RAJOURI GARDEN
4	HARCHINT SINGH ARORA	Bahujan Samaj Party	270	0	270	0.24	RAJOURI GARDEN
5	DEVENDER SINGH	Rashtravadi Janata Party	45	0	45	0.04	RAJOURI GARDEN
6	NAND KISHORE GOEL	Swabhiman Party	73	0	73	0.07	RAJOURI GARDEN
7	RAM BHAROSA GAUTAM	Aapki Apni Party (Peoples)	341	0	341	0.31	RAJOURI GARDEN
8	IQBAL SINGH (SONU)	Independent	109	0	109	0.1	RAJOURI GARDEN
9	MANISH CHANDILA	Independent	88	0	88	0.08	RAJOURI GARDEN
10	SUKHPAL SINGH	Independent	5215	3	5218	4.67	RAJOURI GARDEN
11	NOTA	None of the Above	684	10	694	0.62	RAJOURI GARDEN
1	TAJINDER PAL SINGH BAGGA	Bharatiya Janata Party	37672	284	37956	35.07	HARI NAGAR
2	MAY SINGH SHAYAM	Bahujan Samaj Party	496	3	499	0.46	HARI NAGAR
3	RAJ KUMARI DHILLON	Aam Aadmi Party	57892	195	58087	53.67	HARI NAGAR
4	SURINDER KUMAR SETIA	Indian National Congress	10334	60	10394	9.6	HARI NAGAR
5	DILIP JAISWAL	National Youth Party	63	0	63	0.06	HARI NAGAR
6	KAPIL ARORA	Independent	25	0	25	0.02	HARI NAGAR
7	NAVEEN KUMAR	Independent	29	0	29	0.03	HARI NAGAR
8	RAKESH KUMAR NARANG	Independent	29	0	29	0.03	HARI NAGAR
9	RAJEEV TANEJA	Independent	126	3	129	0.12	HARI NAGAR
10	VIKAS AHUJA	Independent	33	0	33	0.03	HARI NAGAR
11	SABIR KHAN	Independent	48	0	48	0.04	HARI NAGAR
12	SUMIT	Independent	66	0	66	0.06	HARI NAGAR
13	SANTOSH	Independent	224	0	224	0.21	HARI NAGAR
14	HARPREET SINGH	Independent	58	0	58	0.05	HARI NAGAR
15	NOTA	None of the Above	578	14	592	0.55	HARI NAGAR
1	JARNAIL SINGH	Aam Aadmi Party	62265	171	62436	62.2	TILAK NAGAR
2	RAMINDER SINGH	Indian National Congress	1787	20	1807	1.8	TILAK NAGAR
3	RAJIV BABBAR	Bharatiya Janata Party	34223	184	34407	34.28	TILAK NAGAR
4	SANJAY KUMAR	Bahujan Samaj Party	169	3	172	0.17	TILAK NAGAR
5	JARNAIL SINGH	Aapki Apni Party (Peoples)	524	3	527	0.52	TILAK NAGAR
6	JARNAIL SINGH	Independent	304	1	305	0.3	TILAK NAGAR
7	RAJIV ARORA	Independent	85	0	85	0.08	TILAK NAGAR
8	RAJIV BABBAR	Independent	124	0	124	0.12	TILAK NAGAR
9	NOTA	None of the Above	512	10	522	0.52	TILAK NAGAR
1	ASHISH SOOD	Bharatiya Janata Party	52750	301	53051	42.48	JANAKPURI
2	RAJ KUMAR	Bahujan Samaj Party	502	3	505	0.4	JANAKPURI
3	RAJESH RISHI	Aam Aadmi Party	67756	212	67968	54.43	JANAKPURI
4	RADHIKA KHERA	Indian National Congress	2064	20	2084	1.67	JANAKPURI
5	MAHIPAL SINGH	Independent	201	0	201	0.16	JANAKPURI
6	RAMESH CHAND VERMA	Independent	381	0	381	0.31	JANAKPURI
7	NOTA	None of the Above	687	4	691	0.55	JANAKPURI
1	KRISHNA THAKUR	Bahujan Samaj Party	2071	3	2074	0.87	VIKASPURI
2	MAHINDER YADAV	Aam Aadmi Party	133640	258	133898	55.95	VIKASPURI
3	MUKESH SHARMA	Indian National Congress	8273	46	8319	3.48	VIKASPURI
4	SANJAY SINGH	Bharatiya Janata Party	91507	333	91840	38.38	VIKASPURI
5	UMESH CHAUHAN	Rashtriya Rashtrawadi Party	374	1	375	0.16	VIKASPURI
6	GOPAL RANJAN	Aam Janta Party (India)	327	0	327	0.14	VIKASPURI
7	JAI KRISHAN GAUR	Rashtriya Janshakti Party (Secular)	170	0	170	0.07	VIKASPURI
8	BHARAT BHUSHAN GAUTAM	Aam Janata Party (Sarvajana Hitaya)	325	1	326	0.14	VIKASPURI
9	SHARDA DIXIT	SOCIALIST UNITY CENTRE OF INDIA (COMMUNIST)	530	1	531	0.22	VIKASPURI
10	SANJAY GUPTA	Shiv Sena	421	1	422	0.18	VIKASPURI
11	NOTA	None of the Above	1027	7	1034	0.43	VIKASPURI
1	KRISHAN GAHLOT	Bharatiya Janata Party	79446	417	79863	43.75	UTTAM NAGAR
2	DEEPAK RAJPUT	Bahujan Samaj Party	866	12	878	0.48	UTTAM NAGAR
3	NARESH BALYAN	Aam Aadmi Party	99338	284	99622	54.57	UTTAM NAGAR
4	GANGA RAM CHANDRAVANSHI	Proutist Bloc, India	432	1	433	0.24	UTTAM NAGAR
5	SHAKTI KUMAR BISHNOI	Rashtriya Janata Dal	372	5	377	0.21	UTTAM NAGAR
6	SHIKHA SHARMA	Aam Janata Party (Sarvajana Hitaya)	222	2	224	0.12	UTTAM NAGAR
7	MUKH RAM SINGH	Independent	196	0	196	0.11	UTTAM NAGAR
8	RAJIV KUMAR	Independent	116	0	116	0.06	UTTAM NAGAR
9	NOTA	None of the Above	832	6	838	0.46	UTTAM NAGAR
1	ASHOK PAHALWAN	Bahujan Samaj Party	499	1	500	0.37	DWARKA
2	ADARSH SHASTRI	Indian National Congress	6747	10	6757	4.96	DWARKA
3	PARDUYMN RAJPUT	Bharatiya Janata Party	56540	76	56616	41.53	DWARKA
4	VINAY MISHRA	Aam Aadmi Party	70954	49	71003	52.08	DWARKA
5	DEEPAK KUMAR	Rashtriya Janadhikar Party	214	0	214	0.16	DWARKA
6	BALJEET YADAV	Rashtriya Rashtrawadi Party	55	0	55	0.04	DWARKA
7	RAJNISH JHA	National Youth Party	137	0	137	0.1	DWARKA
8	GAUTAM SINGH BIHARI	Independent	220	0	220	0.16	DWARKA
9	VINAY KUMAR SAH	Independent	171	0	171	0.13	DWARKA
10	HARSH VARDHAN	Independent	87	0	87	0.06	DWARKA
11	NOTA	None of the Above	576	2	578	0.42	DWARKA
1	GULAB SINGH	Aam Aadmi Party	138207	803	139010	53.2	MATIALA
2	RAJESH GAHLOT	Bharatiya Janata Party	109659	1276	110935	42.45	MATIALA
3	SHER SINGH	Bahujan Samaj Party	762	12	774	0.3	MATIALA
4	SUMESH SHOKEEN	Indian National Congress	7211	106	7317	2.8	MATIALA
5	ANIL LOHCHUB	Rashtriya Mazdoor Ekta Party	176	0	176	0.07	MATIALA
6	AKASH SHRIVASTAVA	Satya Bahumat Party	125	0	125	0.05	MATIALA
7	MOHINDER SINGH	Rashtriya Rashtrawadi Party	160	0	160	0.06	MATIALA
8	SURENDER KUMAR	Mazdoor Ekta Party	327	2	329	0.13	MATIALA
9	SANDHYA SINGH	Janadhar National Party	887	0	887	0.34	MATIALA
10	NOTA	None of the Above	1588	14	1602	0.61	MATIALA
1	AJEET SINGH KHARKHARI	Bharatiya Janata Party	73868	1408	75276	46.05	NAJAFGARH
2	KAILASH GAHLOT	Aam Aadmi Party	80761	746	81507	49.86	NAJAFGARH
3	MANOJ KUMAR	Bahujan Samaj Party	818	22	840	0.51	NAJAFGARH
4	SAHAB SINGH	Indian National Congress	2311	68	2379	1.46	NAJAFGARH
5	BAIDYANATH SAH	Proutist Bloc, India	159	1	160	0.1	NAJAFGARH
6	AJIT YADAV	Independent	76	2	78	0.05	NAJAFGARH
7	PARVEEN KUMAR	Independent	255	12	267	0.16	NAJAFGARH
8	MOHAMMAD KASIM	Independent	339	0	339	0.21	NAJAFGARH
9	LALIT GOEL	Independent	1887	11	1898	1.16	NAJAFGARH
10	NOTA	None of the Above	720	16	736	0.45	NAJAFGARH
1	DEEPAK	Bahujan Samaj Party	627	4	631	0.5	BIJWASAN
2	PARVEEN RANA	Indian National Congress	5893	44	5937	4.75	BIJWASAN
3	BHUPINDER SINGH JOON	Aam Aadmi Party	57098	173	57271	45.83	BIJWASAN
4	SAT PRAKASH RANA	Bharatiya Janata Party	56203	315	56518	45.22	BIJWASAN
5	DHANJI SHARMA	Rashtriya Aikta Manch Party	131	0	131	0.1	BIJWASAN
6	NITU YADAV	Ambedkar National Congress	100	0	100	0.08	BIJWASAN
7	PARDEEP MAURYA	National Youth Party	42	0	42	0.03	BIJWASAN
8	MANOJ KUMAR	Lok Jan Shakti Party	45	0	45	0.04	BIJWASAN
9	MANJU YADAV	Swaraj India	324	1	325	0.26	BIJWASAN
10	RAM NIWAS	Hindusthan Nirman Dal	577	5	582	0.47	BIJWASAN
11	LOKENDER KAPASHERA	Aapki Apni Party (Peoples)	2529	15	2544	2.04	BIJWASAN
12	ANIL	Independent	193	0	193	0.15	BIJWASAN
13	KAMESHWAR THAKUR	Independent	205	0	205	0.16	BIJWASAN
14	NOTA	None of the Above	442	6	448	0.36	BIJWASAN
1	GEETA	Bahujan Samaj Party	772	14	786	0.5	PALAM
2	DALIP KUMAR	Communist Party of India	481	3	484	0.31	PALAM
3	BHAVNA GAUR	Aam Aadmi Party	92412	363	92775	59.15	PALAM
4	VIJAY PANDIT	Bharatiya Janata Party	59565	445	60010	38.26	PALAM
5	NIRMAL KUMAR SINGH	Rashtriya Janata Dal	547	5	552	0.35	PALAM
6	RAJESH KUMAR	Republican Party of India (A)	96	0	96	0.06	PALAM
7	SATDEV JAIN	Proutist Bloc, India	324	0	324	0.21	PALAM
8	SANTOSH CHOUDHARY	National Youth Party	162	0	162	0.1	PALAM
9	JITENDAR KUMAR	Independent	118	0	118	0.08	PALAM
10	NAGENDER SINGH	Independent	217	0	217	0.14	PALAM
11	RAM SINGH BISHT	Independent	313	1	314	0.2	PALAM
12	HARI RATTAN SOLANKI	Independent	162	3	165	0.11	PALAM
13	NOTA	None of the Above	826	22	848	0.54	PALAM
1	Nand Kishore Beniwal	Bahujan Samaj Party	1822	1	1823	3.09	DELHI CANTT
2	Manish Singh	Bharatiya Janata Party	18259	122	18381	31.19	DELHI CANTT
3	Virender Singh Kadian	Aam Aadmi Party	28880	91	28971	49.17	DELHI CANTT
4	Surender Singh	Nationalist Congress Party	904	4	908	1.54	DELHI CANTT
5	Sandeep Tanwar	Indian National Congress	7923	31	7954	13.5	DELHI CANTT
6	Nagendra Kumar Tiwari	National Youth Party	81	0	81	0.14	DELHI CANTT
7	Sachin Kumar	Bhartiya Samajik Nyay Party	127	0	127	0.22	DELHI CANTT
8	Ishwar	Independent	47	0	47	0.08	DELHI CANTT
9	Bir Singh Chauhan	Independent	84	0	84	0.14	DELHI CANTT
10	Manoj Bawan	Independent	36	0	36	0.06	DELHI CANTT
11	Sachin	Independent	161	0	161	0.27	DELHI CANTT
12	Sanjeev Kumar	Independent	73	0	73	0.12	DELHI CANTT
13	NOTA	None of the Above	276	4	280	0.48	DELHI CANTT
1	JAGDISH	Bahujan Samaj Party	379	3	382	0.37	RAJINDER NAGAR
2	RAGHAV CHADHA	Aam Aadmi Party	58943	192	59135	57.06	RAJINDER NAGAR
3	ROCKY TUSEED	Indian National Congress	3922	19	3941	3.8	RAJINDER NAGAR
4	SARDAR R P SINGH	Bharatiya Janata Party	38876	201	39077	37.7	RAJINDER NAGAR
5	SHASHI RAJ	Bhartiya Samajik Nyay Party	155	0	155	0.15	RAJINDER NAGAR
6	SATENDRA NARAYAN SINGH	Purvanchal Janta Party (Secular)	484	2	486	0.47	RAJINDER NAGAR
7	NOTA	None of the Above	463	4	467	0.45	RAJINDER NAGAR
1	ARVIND KEJRIWAL	Aam Aadmi Party	46526	232	46758	61.1	NEW DELHI
2	RAM GULAM	Bahujan Samaj Party	134	2	136	0.18	NEW DELHI
3	ROMESH SABHARWAL	Indian National Congress	3206	14	3220	4.21	NEW DELHI
4	SUNIL KUMAR YADAV	Bharatiya Janata Party	24876	185	25061	32.75	NEW DELHI
5	AJAY TIWARI	Right to Recall Party	57	0	57	0.07	NEW DELHI
6	ADITI SHARMA	Hindustani Awam Morcha (Secular)	21	1	22	0.03	NEW DELHI
7	AMIT SHARMA	Vijay Bharat Party	9	0	9	0.01	NEW DELHI
8	ASHOK AGYANI	Bhartiya Samajik Nyay Party	36	1	37	0.05	NEW DELHI
9	M U DUA	Aihra National Party	24	0	24	0.03	NEW DELHI
10	NARENDER KUMAR BANSAL	Bharatiya Loktantrik Party(Gandhi-Lohiawadi)	10	0	10	0.01	NEW DELHI
11	PRATAP CHANDRA	Rashtriya Rashtrawadi Party	15	0	15	0.02	NEW DELHI
12	MAHENDER SINGH	Peoples Party of India (Democratic)	28	0	28	0.04	NEW DELHI
13	MEENA SURYAWANSHI	Republican Party of India (Athawale)	24	0	24	0.03	NEW DELHI
14	RAMESH NARAIN SINGH	Vishva Shakti Party	19	0	19	0.02	NEW DELHI
15	RAJBIR	Bahujan Dravida Party	16	0	16	0.02	NEW DELHI
16	SHEALENDERA SINGH	Anjaan Aadmi Party	99	0	99	0.13	NEW DELHI
17	SAMPURNA NAND UNIYAL	Jan Awaz Vikas Party	199	3	202	0.26	NEW DELHI
18	KIRTI SINGH PANWAR	Independent	21	0	21	0.03	NEW DELHI
19	Daya Shankar Agrawal	Independent	41	0	41	0.05	NEW DELHI
20	YOGENDER SINGH	Independent	87	0	87	0.11	NEW DELHI
21	RAMESH KUMAR KHATRI	Independent	12	0	12	0.02	NEW DELHI
22	RAHUL KUMAR	Independent	25	0	25	0.03	NEW DELHI
23	RAHUL BENIWAL	Independent	21	0	21	0.03	NEW DELHI
24	VIKAS SHARMA	Independent	67	0	67	0.09	NEW DELHI
25	SHIV KUMAR	Independent	9	0	9	0.01	NEW DELHI
26	SANNI KAUSHIK	Independent	66	0	66	0.09	NEW DELHI
27	SANT DHARMVEER CHOTIWALA	Independent	14	0	14	0.02	NEW DELHI
28	SANDEEP SRIVASTAVA	Independent	35	0	35	0.05	NEW DELHI
29	NOTA	None of the Above	392	3	395	0.52	NEW DELHI
1	IMPREET SINGH BAKSHI	Bharatiya Janata Party	28995	75	29070	32.77	JANGPURA
2	TARVINDER SINGH MARWAH	Indian National Congress	13548	17	13565	15.29	JANGPURA
3	PRAVEEN KUMAR	Aam Aadmi Party	45086	47	45133	50.88	JANGPURA
4	SUBHASH	Bahujan Samaj Party	247	0	247	0.28	JANGPURA
5	CHANDRASHEKHAR SINGH	Independent	156	0	156	0.18	JANGPURA
6	MOHD. ASLAM	Independent	113	0	113	0.13	JANGPURA
7	NOTA	None of the Above	416	3	419	0.47	JANGPURA
1	ABHISHEK DUTT	Indian National Congress	19586	62	19648	21.42	KASTURBA NAGAR
2	KHEM CHAND	Bahujan Samaj Party	282	1	283	0.31	KASTURBA NAGAR
3	MADAN LAL	Aam Aadmi Party	37039	61	37100	40.45	KASTURBA NAGAR
4	RAVINDER CHOUDHRY	Bharatiya Janata Party	33798	137	33935	37	KASTURBA NAGAR
5	SUMAN LATA KATIYAR	Aam Janta Party (India)	281	0	281	0.31	KASTURBA NAGAR
6	NOTA	None of the Above	463	0	463	0.5	KASTURBA NAGAR
1	NEETU VERMA SOIN	Indian National Congress	2835	21	2856	3.18	MALVIYA NAGAR
2	SHAILENDER SINGH	Bharatiya Janata Party	33690	209	33899	37.76	MALVIYA NAGAR
3	SOMNATH BHARTI	Aam Aadmi Party	51941	102	52043	57.97	MALVIYA NAGAR
4	GYAN CHAND GAUTAM	Bahujan Samaj Party	227	2	229	0.26	MALVIYA NAGAR
5	MOBIN ALI	Shiv Sena	115	0	115	0.13	MALVIYA NAGAR
6	KAMAL SINGH	Independent	87	0	87	0.1	MALVIYA NAGAR
7	NOTA	None of the Above	548	1	549	0.61	MALVIYA NAGAR
1	ANIL KUMAR SHARMA	Bharatiya Janata Party	36528	311	36839	40.93	R K PURAM
2	NAGESHWAR DAS	Bahujan Samaj Party	297	4	301	0.33	R K PURAM
3	PRAMILA TOKAS	Aam Aadmi Party	46945	263	47208	52.45	R K PURAM
4	PRIYANKA SINGH	Indian National Congress	3216	21	3237	3.6	R K PURAM
5	MUKESH	Bhartiya Samajik Nyay Party	181	0	181	0.2	R K PURAM
6	KUMAR SHEODHVJ RATNA	Independent	160	0	160	0.18	R K PURAM
7	MAHIPAL SINGH	Independent	1548	3	1551	1.72	R K PURAM
8	NOTA	None of the Above	523	4	527	0.59	R K PURAM
1	KAMAL SINGH	Bahujan Samaj Party	465	5	470	0.41	MEHRAULI
2	KUSUM KHATRI	Bharatiya Janata Party	44085	171	44256	38.48	MEHRAULI
3	NARESH YADAV	Aam Aadmi Party	62301	116	62417	54.27	MEHRAULI
4	A A MAHENDER CHAUDHARY	Indian National Congress	6936	16	6952	6.04	MEHRAULI
5	D K CHOPRA	All India Forward Bloc	163	0	163	0.14	MEHRAULI
6	JAI SINGH UJJAIN	Swaraj India	156	0	156	0.14	MEHRAULI
7	NOTA	None of the Above	592	1	593	0.52	MEHRAULI
1	KARTAR SINGH TANWAR	Aam Aadmi Party	69288	123	69411	49.13	CHHATARPUR
2	BRAHM SINGH TANWAR	Bharatiya Janata Party	65530	161	65691	46.5	CHHATARPUR
3	RANA SUJEET SINGH	Nationalist Congress Party	177	0	177	0.13	CHHATARPUR
4	SATISH LOHIA	Indian National Congress	3857	17	3874	2.74	CHHATARPUR
5	SURAJ BHARTI	Bahujan Samaj Party	363	6	369	0.26	CHHATARPUR
6	RAM KHELAVAN	Proutist Bloc, India	408	0	408	0.29	CHHATARPUR
7	RAM PRIYE THAKUR	Satya Bahumat Party	76	1	77	0.05	CHHATARPUR
8	SEEMA VERMA	Indian Praja Congress	73	2	75	0.05	CHHATARPUR
9	SANGEETA SINGH	Rashtriya Rashtrawadi Party	96	0	96	0.07	CHHATARPUR
10	DINESH TANWAR	Independent	79	0	79	0.06	CHHATARPUR
11	ROHIT	Independent	101	0	101	0.07	CHHATARPUR
12	HARSH NATH VERMA	Independent	216	0	216	0.15	CHHATARPUR
13	NOTA	None of the Above	707	2	709	0.5	CHHATARPUR
1	ARVIND KUMAR	Bharatiya Janata Party	52299	103	52402	34.86	DEOLI(SC)
2	ARVINDER SINGH	Indian National Congress	2700	11	2711	1.8	DEOLI(SC)
3	PRAKASH @ PRAKASH JARWAL	Aam Aadmi Party	92458	117	92575	61.59	DEOLI(SC)
4	RAVI KUMAR	Bahujan Samaj Party	1029	3	1032	0.69	DEOLI(SC)
5	DAL CHAND KAPIL	SOCIAL DEMOCRATIC PARTY OF INDIA	474	0	474	0.32	DEOLI(SC)
6	RADHY SHYAM	Bhartiya Samajik Nyay Party	418	1	419	0.28	DEOLI(SC)
7	NOTA	None of the Above	702	1	703	0.47	DEOLI(SC)
1	AJAY DUTT	Aam Aadmi Party	62647	224	62871	62.25	AMBEDKAR NAGAR(SC)
2	KHUSHIRAM CHUNAR	Bharatiya Janata Party	34394	150	34544	34.2	AMBEDKAR NAGAR(SC)
3	YADURAJ CHOUDHARY	Indian National Congress	2127	11	2138	2.12	AMBEDKAR NAGAR(SC)
4	SATISH	Bahujan Samaj Party	616	4	620	0.61	AMBEDKAR NAGAR(SC)
5	NARESH KUMAR CHANDALIYA	Rashtriya Janadhikar Party	83	1	84	0.08	AMBEDKAR NAGAR(SC)
6	RASHMI RAIKWAR	Independent	249	1	250	0.25	AMBEDKAR NAGAR(SC)
7	NOTA	None of the Above	493	3	496	0.49	AMBEDKAR NAGAR(SC)
1	DINESH MOHANIYA	Aam Aadmi Party	75307	38	75345	64.58	SANGAM VIHAR
2	Poonam Azad	Indian National Congress	2601	3	2604	2.23	SANGAM VIHAR
3	Suresh Choudhary	Bahujan Samaj Party	2927	3	2930	2.51	SANGAM VIHAR
4	Kali Paswan	Peoples Party of India (Democratic)	500	0	500	0.43	SANGAM VIHAR
5	Rambhavan Ojha	Manvadhikar National Party	615	0	615	0.53	SANGAM VIHAR
6	Shiv Charan Lal Gupta	Janata Dal (United)	32803	20	32823	28.13	SANGAM VIHAR
7	Harit Kumar	Sabse Badi Party	143	1	144	0.12	SANGAM VIHAR
8	MAYA	Independent	540	0	540	0.46	SANGAM VIHAR
9	Sachin Choudhary	Independent	293	0	293	0.25	SANGAM VIHAR
10	NOTA	None of the Above	870	2	872	0.75	SANGAM VIHAR
1	RAJBIR SINGH	Bahujan Samaj Party	213	1	214	0.2	GREATER KAILASH
2	SHIKHA ROY	Bharatiya Janata Party	43398	165	43563	40.13	GREATER KAILASH
3	SUKHBIR SINGH PANWAR	Indian National Congress	3319	20	3339	3.08	GREATER KAILASH
4	SAURABH BHARADWAJ	Aam Aadmi Party	60231	141	60372	55.62	GREATER KAILASH
5	SHOBHA DHAR	Proutist Bloc, India	281	1	282	0.26	GREATER KAILASH
6	RAJIV GUPTA	Independent	86	0	86	0.08	GREATER KAILASH
7	LUKMAN KHAN	Independent	105	1	106	0.1	GREATER KAILASH
8	NOTA	None of the Above	586	0	586	0.54	GREATER KAILASH
1	ATISHI	Aam Aadmi Party	55833	64	55897	52.28	KALKAJI
2	JAY PRAKASH SHARMA	Bahujan Samaj Party	473	0	473	0.44	KALKAJI
3	DHARAMBIR SINGH	Bharatiya Janata Party	44411	93	44504	41.63	KALKAJI
4	SHIVANI CHOPRA	Indian National Congress	4956	9	4965	4.64	KALKAJI
5	PARVESH KUMAR	Swaraj India	301	0	301	0.28	KALKAJI
6	DR. SUMAN YADAV	Parivartan Samaj Party	219	0	219	0.2	KALKAJI
7	NOTA	None of the Above	550	1	551	0.52	KALKAJI
1	MANOJ KUMAR RAY	Bahujan Samaj Party	1312	4	1316	1.22	TUGHLAKABAD
2	VIKRAM BIDHURI	Bharatiya Janata Party	45093	54	45147	41.77	TUGHLAKABAD
3	SHUBHAM SHARMA	Indian National Congress	1337	5	1342	1.24	TUGHLAKABAD
4	SAHIRAM	Aam Aadmi Party	58838	67	58905	54.51	TUGHLAKABAD
5	ARUN KUMAR	Rashtra Nirman Party	165	0	165	0.15	TUGHLAKABAD
6	CHAMAN LAL	Peoples Party of India (Democratic)	55	0	55	0.05	TUGHLAKABAD
7	SHYAM KUMAR	Sajag Samaj Party	134	0	134	0.12	TUGHLAKABAD
8	ANITA KUMARI	Independent	268	0	268	0.25	TUGHLAKABAD
9	REKHA SINGH	Independent	120	0	120	0.11	TUGHLAKABAD
10	HANSRAJ NAGAR	Independent	236	0	236	0.22	TUGHLAKABAD
11	NOTA	None of the Above	383	1	384	0.36	TUGHLAKABAD
1	JAGDISH CHAND	Communist Party of India  (Marxist)	683	0	683	0.36	BADARPUR
2	NARAYAN DUTT SHARMA	Bahujan Samaj Party	10414	22	10436	5.45	BADARPUR
3	PRAMOD KUMAR YADAV	Indian National Congress	1610	5	1615	0.84	BADARPUR
4	RAM SINGH NETAJI	Aam Aadmi Party	86286	77	86363	45.11	BADARPUR
5	RAMVIR SINGH BIDHURI	Bharatiya Janata Party	89972	110	90082	47.05	BADARPUR
6	BRIJNARAYAN MISHRA	Rashtriya Rashtrawadi Party	318	0	318	0.17	BADARPUR
7	YADUBANSH SINGH	Proutist Bloc, India	361	0	361	0.19	BADARPUR
8	SANJEEV KUMAR	Jan Adhikar Party	222	0	222	0.12	BADARPUR
9	OM PRAKASH GUPTA	Independent	260	0	260	0.14	BADARPUR
10	CHHOTE LAL GUPTA	Independent	370	0	370	0.19	BADARPUR
11	NOTA	None of the Above	745	5	750	0.39	BADARPUR
1	AMANATULLAH KHAN	Aam Aadmi Party	130163	204	130367	66.03	OKHLA
2	DHARAM SINGH	Bahujan Samaj Party	828	2	830	0.42	OKHLA
3	PARVEZ HASHMI	Indian National Congress	5107	16	5123	2.59	OKHLA
4	BRAHAM SINGH	Bharatiya Janata Party	58499	41	58540	29.65	OKHLA
5	M.I. ANSARI	Jagrook Janta Party	340	0	340	0.17	OKHLA
6	DR. CHANDRA RAJAN ARORA	Liberal Party of India	46	0	46	0.02	OKHLA
7	TASLEEM AHMED REHMANI	SOCIAL DEMOCRATIC PARTY OF INDIA	149	0	149	0.08	OKHLA
8	DEVNARAYAN THAKUR	Rashtravadi Janata Party	77	0	77	0.04	OKHLA
9	MUSARRAT ALI KHAN	Rastriya Aam Jan Seva Party	175	1	176	0.09	OKHLA
10	VED PRAKASH	Awami Party	36	0	36	0.02	OKHLA
11	SHAZIA FAIZAN	Ambedkar National Congress	55	0	55	0.03	OKHLA
12	ABHAY RAJ	Independent	166	0	166	0.08	OKHLA
13	AWANINDRA KUMAR CHOUBEY	Independent	191	0	191	0.1	OKHLA
14	JAMALUDDIN	Independent	613	0	613	0.31	OKHLA
15	BABAR RIYAZ	Independent	85	0	85	0.04	OKHLA
16	NOTA	None of the Above	637	0	637	0.32	OKHLA
1	KIRAN	Bharatiya Janata Party	57293	168	57461	43.01	TRILOKPURI(SC)
2	RAGHU RAJ SINGH	Bahujan Samaj Party	1214	10	1224	0.92	TRILOKPURI(SC)
3	ROHIT KUMAR	Aam Aadmi Party	69819	128	69947	52.36	TRILOKPURI(SC)
4	VIJAY KUMAR	Indian National Congress	3246	16	3262	2.44	TRILOKPURI(SC)
5	AJAY CHAUHAN	Bhartiya Samajik Nyay Party	198	0	198	0.15	TRILOKPURI(SC)
6	AKSHTIZ BIRMANI	Rashtriya Samaj Paksha	191	0	191	0.14	TRILOKPURI(SC)
7	MAYANK KUMAR	Sabse Badi Party	124	0	124	0.09	TRILOKPURI(SC)
8	RAJESH KUMAR	Aam Janta Party (India)	182	0	182	0.14	TRILOKPURI(SC)
9	VIKRAM	Janshakti Party (Rashtriya)	259	0	259	0.19	TRILOKPURI(SC)
10	KAVITA RANI SINGH	Independent	152	1	153	0.11	TRILOKPURI(SC)
11	NOTA	None of the Above	589	1	590	0.44	TRILOKPURI(SC)
1	AMRISH SINGH GAUTAM	Indian National Congress	5808	53	5861	4.55	KONDLI(SC)
2	KARMVIR	Bahujan Samaj Party	2666	48	2714	2.11	KONDLI(SC)
3	KULDEEP KUMAR	Aam Aadmi Party	68100	248	68348	53.11	KONDLI(SC)
4	RAJ KUMAR	Bharatiya Janata Party	50236	205	50441	39.2	KONDLI(SC)
5	DINESH KUMAR KASHYAP	Sabse Badi Party	212	0	212	0.16	KONDLI(SC)
6	AMAR SINGH	Independent	172	0	172	0.13	KONDLI(SC)
7	AKSHAY KUMAR	Independent	375	0	375	0.29	KONDLI(SC)
8	NOTA	None of the Above	552	5	557	0.43	KONDLI(SC)
1	Manish Sisodia	Aam Aadmi Party	69974	189	70163	49.33	PATPARGANJ
2	Ravinder Singh Negi	Bharatiya Janata Party	66703	253	66956	47.07	PATPARGANJ
3	Rakesh	Bahujan Samaj Party	665	11	676	0.48	PATPARGANJ
4	Laxman Rawat	Indian National Congress	2767	35	2802	1.97	PATPARGANJ
5	Pratap Chandra	Rashtriya Rashtrawadi Party	95	0	95	0.07	PATPARGANJ
6	Rakesh Suri	Right to Recall Party	60	0	60	0.04	PATPARGANJ
7	Vinay Kumar Singh	Janshakti Party (Rashtriya)	43	0	43	0.03	PATPARGANJ
8	Shatrughan Kumar Singh	Hindustani Awam Morcha (Secular)	46	0	46	0.03	PATPARGANJ
9	Sanjeev Bhati	Hindusthan Nirman Dal	184	0	184	0.13	PATPARGANJ
10	Surender Gupta	Janmat Party	321	0	321	0.23	PATPARGANJ
11	Gopal Prasad	Independent	77	0	77	0.05	PATPARGANJ
12	Manoj Kumar	Independent	79	0	79	0.06	PATPARGANJ
13	Surjeet Singh	Independent	215	0	215	0.15	PATPARGANJ
14	NOTA	None of the Above	524	5	529	0.37	PATPARGANJ
1	ABHAY VERMA	Bharatiya Janata Party	65462	273	65735	48.04	LAXMI NAGAR
2	JAI RAM LAL	Bahujan Samaj Party	439	7	446	0.33	LAXMI NAGAR
3	NITIN TYAGI	Aam Aadmi Party	64629	226	64855	47.4	LAXMI NAGAR
4	HARI DUTT SHARMA	Indian National Congress	4836	36	4872	3.56	LAXMI NAGAR
5	ANIMA OJHA	Right to Recall Party	77	1	78	0.06	LAXMI NAGAR
6	R D TIWARI	Lok Shakti Party (Loktantrik)	73	0	73	0.05	LAXMI NAGAR
7	DEEP KUMAR	Liberal Party of India	135	0	135	0.1	LAXMI NAGAR
8	NAMAHA	Lok Jan Shakti Party	76	0	76	0.06	LAXMI NAGAR
9	NOTA	None of the Above	545	5	550	0.4	LAXMI NAGAR
1	OM PRAKASH SHARMA	Bharatiya Janata Party	65335	495	65830	52.57	VISHWAS NAGAR
2	GURCHARAN SINGH	Indian National Congress	7801	80	7881	6.29	VISHWAS NAGAR
3	DILEEP GAUTAM	Bahujan Samaj Party	726	13	739	0.59	VISHWAS NAGAR
4	DEEPAK SINGLA	Aam Aadmi Party	49170	203	49373	39.42	VISHWAS NAGAR
5	ANIL KUMAR	National Youth Party	133	2	135	0.11	VISHWAS NAGAR
6	BABU RAM	Peoples Party of India (Democratic)	67	0	67	0.05	VISHWAS NAGAR
7	SADHNA	Jindabad Kranti Party	106	0	106	0.08	VISHWAS NAGAR
8	ASHOK SURANA	Independent	105	0	105	0.08	VISHWAS NAGAR
9	NEESHA	Independent	143	0	143	0.11	VISHWAS NAGAR
10	NOTA	None of the Above	834	20	854	0.68	VISHWAS NAGAR
1	Dr. Anil Goyal	Bharatiya Janata Party	67809	307	68116	46.38	KRISHNA NAGAR
2	Dr. Ashok Kumar Walia	Indian National Congress	5032	47	5079	3.46	KRISHNA NAGAR
3	S. K. Bagga (Advocate)	Aam Aadmi Party	71936	175	72111	49.1	KRISHNA NAGAR
4	Advocate Manjeet Singh	Bahujan Samaj Party	358	4	362	0.25	KRISHNA NAGAR
5	Charanjeet	Aapki Apni Party (Peoples)	304	2	306	0.21	KRISHNA NAGAR
6	Munish Bagga	Rashtriya Rashtrawadi Party	234	1	235	0.16	KRISHNA NAGAR
7	Suresh Kumar	Baliraja Party	114	0	114	0.08	KRISHNA NAGAR
8	NOTA	None of the Above	527	5	532	0.36	KRISHNA NAGAR
1	ANIL KUMAR BAJPAI	Bharatiya Janata Party	48657	167	48824	42.64	GANDHI NAGAR
2	ARVINDER SINGH LOVELY	Indian National Congress	21818	95	21913	19.14	GANDHI NAGAR
3	TIKRAJ SINGH	Bahujan Samaj Party	352	5	357	0.31	GANDHI NAGAR
4	NAVEEN CHAUDHARY	Aam Aadmi Party	42610	135	42745	37.33	GANDHI NAGAR
5	MUKESH KUMAR	Independent	164	0	164	0.14	GANDHI NAGAR
6	RAVINDRA KUMAR	Independent	88	0	88	0.08	GANDHI NAGAR
7	MD. HAROON	Independent	90	0	90	0.08	GANDHI NAGAR
8	NOTA	None of the Above	326	0	326	0.28	GANDHI NAGAR
1	INDU	Bahujan Samaj Party	677	25	702	0.56	SHAHDARA
2	DR. NARENDER NATH	Indian National Congress	4387	87	4474	3.57	SHAHDARA
3	RAM NIWAS GOEL	Aam Aadmi Party	61808	295	62103	49.53	SHAHDARA
4	SANJAY GOYAL	Bharatiya Janata Party	56416	393	56809	45.31	SHAHDARA
5	ALLAH BAKASH	Rashtriya Jansambhavna Party	223	0	223	0.18	SHAHDARA
6	NISHANT SHARMA	Proutist Bloc, India	375	0	375	0.3	SHAHDARA
7	RANJANA MUNESH CHAUHAN	Bhartiya Samajik Nyay Party	195	0	195	0.16	SHAHDARA
8	VIMLA	Sabse Badi Party	91	0	91	0.07	SHAHDARA
9	NOTA	None of the Above	405	6	411	0.33	SHAHDARA
1	KAMAL SINGH	Bahujan Samaj Party	1532	33	1565	1.17	SEEMA PURI(SC)
2	RAJENDRA PAL GAUTAM	Aam Aadmi Party	88080	312	88392	65.82	SEEMA PURI(SC)
3	VEER SINGH DHINGAN	Indian National Congress	7568	93	7661	5.7	SEEMA PURI(SC)
4	BADAN SINGH	Sarvjan Lok Shakti Party	1099	5	1104	0.82	SEEMA PURI(SC)
5	MANOJ KUMAR	Peoples Party of India (Democratic)	716	4	720	0.54	SEEMA PURI(SC)
6	RAJESH KUMAR LOHIYA	Bhartiya Samajik Nyay Party	271	0	271	0.2	SEEMA PURI(SC)
7	LALIT KUMAR	Mazdoor Ekta Party	418	1	419	0.31	SEEMA PURI(SC)
8	VIJAY	Jan Seva Sahayak Party	357	1	358	0.27	SEEMA PURI(SC)
9	SANT LAL	Lok Jan Shakti Party	32138	146	32284	24.04	SEEMA PURI(SC)
10	KANISHK SINGH	Independent	515	0	515	0.38	SEEMA PURI(SC)
11	NOTA	None of the Above	973	29	1002	0.75	SEEMA PURI(SC)
1	Jitender Mahajan	Bharatiya Janata Party	73377	496	73873	51.94	ROHTAS NAGAR
2	Vipin Sharma	Indian National Congress	5513	59	5572	3.92	ROHTAS NAGAR
3	Sarita Singh	Aam Aadmi Party	60389	243	60632	42.63	ROHTAS NAGAR
4	Trivender	Bahujan Samaj Party	608	11	619	0.44	ROHTAS NAGAR
5	Manish Kumar	Nyay Party	92	0	92	0.06	ROHTAS NAGAR
6	Sanjeev Kumar	Aapki Apni Party (Peoples)	226	0	226	0.16	ROHTAS NAGAR
7	Anupam Sharma	Independent	376	0	376	0.26	ROHTAS NAGAR
8	Pankaj Gupta	Independent	212	0	212	0.15	ROHTAS NAGAR
9	Mukesh Babu Saxena	Independent	112	0	112	0.08	ROHTAS NAGAR
10	NOTA	None of the Above	507	6	513	0.36	ROHTAS NAGAR
1	MOHD. AFZAL	Bahujan Samaj Party	348	4	352	0.27	SEELAMPUR
2	ABDUL REHMAN	Aam Aadmi Party	72611	83	72694	56.05	SEELAMPUR
3	KAUSHAL KUMAR MISHRA	Bharatiya Janata Party	35619	155	35774	27.58	SEELAMPUR
4	CHAUDHARY MATEEN AHMAD	Indian National Congress	20207	40	20247	15.61	SEELAMPUR
5	RAHISUDDIN AHMAD	Bahujan Maha Party	175	0	175	0.13	SEELAMPUR
6	SUKHDEB SINGH SINGH	Rashtriya Jansambhavna Party	151	0	151	0.12	SEELAMPUR
7	NOTA	None of the Above	311	0	311	0.24	SEELAMPUR
1	AJAY MAHAWAR	Bharatiya Janata Party	81336	461	81797	57.55	GHONDA
2	BHISHAM SHARMA	Indian National Congress	5448	36	5484	3.86	GHONDA
3	SHRIDUTT SHARMA	Aam Aadmi Party	53221	206	53427	37.59	GHONDA
4	ANIL SINGH	Sarvjan Lok Shakti Party	156	2	158	0.11	GHONDA
5	AVNI DHILWAL	Nyay Party	62	0	62	0.04	GHONDA
6	Dr. TEJPAL	Right to Recall Party	77	0	77	0.05	GHONDA
7	BIMLESH KUMAR SHARMA	Satya Bahumat Party	42	0	42	0.03	GHONDA
8	MANISH KUMAR	Mazdoor Kirayedar Vikas Party	131	0	131	0.09	GHONDA
9	MAN SINGH	Jindabad Kranti Party	91	0	91	0.06	GHONDA
10	REEMA	Rashtravadi Janata Party	73	0	73	0.05	GHONDA
11	K. P. RANGARI	Peoples Party of India (Democratic)	163	0	163	0.11	GHONDA
12	HARISH	Independent	120	0	120	0.08	GHONDA
13	NOTA	None of the Above	508	4	512	0.36	GHONDA
1	ANVEEKSHA JAIN	Indian National Congress	5109	22	5131	3.59	BABARPUR
2	GOPAL RAI	Aam Aadmi Party	84587	189	84776	59.39	BABARPUR
3	ZAHID ALI	Nationalist Congress Party	150	0	150	0.11	BABARPUR
4	DHARM SINGH	Bahujan Samaj Party	204	7	211	0.15	BABARPUR
5	NARESH GAUR	Bharatiya Janata Party	51323	391	51714	36.23	BABARPUR
6	KALI RAM	Peoples Party of India (Democratic)	114	0	114	0.08	BABARPUR
7	PRINCE KUMAR	Mazdoor Ekta Party	55	0	55	0.04	BABARPUR
8	SADEQUE MUNIRODDIN SHAIKH	Tipu Sultan Party	37	0	37	0.03	BABARPUR
9	JAKIR CHAUDHARY	Independent	54	0	54	0.04	BABARPUR
10	SHIVANI GAUR	Independent	164	0	164	0.11	BABARPUR
11	NOTA	None of the Above	327	3	330	0.23	BABARPUR
1	PRAVEEN KUMAR	Bahujan Samaj Party	4558	41	4599	2.77	GOKALPUR(SC)
2	FATEH SINGH	Nationalist Congress Party	418	2	420	0.25	GOKALPUR(SC)
3	RANJEET SINGH	Bharatiya Janata Party	68575	389	68964	41.5	GOKALPUR(SC)
4	S P SINGH	Indian National Congress	2212	21	2233	1.34	GOKALPUR(SC)
5	SURENDRA KUMAR	Aam Aadmi Party	88090	362	88452	53.22	GOKALPUR(SC)
6	RAVI KUMAR	Peoples Party of India (Democratic)	342	0	342	0.21	GOKALPUR(SC)
7	SHANU KUMAR	Aapki Apni Party (Peoples)	593	0	593	0.36	GOKALPUR(SC)
8	SUNITA DEVI	Nyay Party	137	0	137	0.08	GOKALPUR(SC)
9	NOTA	None of the Above	449	7	456	0.27	GOKALPUR(SC)
1	ALI MEHDI	Indian National Congress	5355	8	5363	2.89	MUSTAFABAD
2	JAGDISH PRADHAN	Bharatiya Janata Party	77845	301	78146	42.06	MUSTAFABAD
3	MAYUR BHAN	Nationalist Congress Party	288	0	288	0.16	MUSTAFABAD
4	SURESH KUMAR MALKANI	Bahujan Samaj Party	1185	19	1204	0.65	MUSTAFABAD
5	HAJI YUNUS	Aam Aadmi Party	98681	169	98850	53.2	MUSTAFABAD
6	ANIL KUMAR GUPTA	Lok Jan Shakti Party	234	0	234	0.13	MUSTAFABAD
7	IMRAN MATLUB KHAN	Tipu Sultan Party	42	0	42	0.02	MUSTAFABAD
8	KAMAL	Hindusthan Nirman Dal	59	0	59	0.03	MUSTAFABAD
9	POONAM	Nyay Party	80	0	80	0.04	MUSTAFABAD
10	MANISH KUMAR	Mazdoor Kirayedar Vikas Party	116	2	118	0.06	MUSTAFABAD
11	MURARI LAL	Aapki Apni Party (Peoples)	266	0	266	0.14	MUSTAFABAD
12	VIVEK TOMAR	National Youth Party	263	0	263	0.14	MUSTAFABAD
13	SUBHASH	Rashtriya Janmorcha	78	0	78	0.04	MUSTAFABAD
14	SHAMA PARVEEN	Independent	94	0	94	0.05	MUSTAFABAD
15	SHIV KUMAR	Independent	245	0	245	0.13	MUSTAFABAD
16	NOTA	None of the Above	459	3	462	0.25	MUSTAFABAD
1	ARBIND SINGH	Indian National Congress	2236	6	2242	1.17	KARAWAL NAGAR
2	DURGESH PATHAK	Aam Aadmi Party	88317	181	88498	46.29	KARAWAL NAGAR
3	NATHU RAM	Bahujan Samaj Party	818	6	824	0.43	KARAWAL NAGAR
4	MOHAN SINGH BISHT	Bharatiya Janata Party	96390	331	96721	50.59	KARAWAL NAGAR
5	RANJIT TIWARI	Communist Party of India  (Marxist)	413	1	414	0.22	KARAWAL NAGAR
6	IMRAN KHAN	Tipu Sultan Party	61	0	61	0.03	KARAWAL NAGAR
7	MOHD. ILIAS	SOCIAL DEMOCRATIC PARTY OF INDIA	169	0	169	0.09	KARAWAL NAGAR
8	PRADESH KUMAR RAGHAV	Sarvodaya Prabhat Party	63	0	63	0.03	KARAWAL NAGAR
9	BANDANA PANDEY	Socialist Party (India)	168	0	168	0.09	KARAWAL NAGAR
10	BHASKARANAND MUNDEPI	SOCIALIST UNITY CENTRE OF INDIA (COMMUNIST)	189	0	189	0.1	KARAWAL NAGAR
11	MOHD. MEHBOB ALAM	Rashtriya Republican Party	66	0	66	0.03	KARAWAL NAGAR
12	VIPIN KUMAR TIWARI	Rashtriya Rashtrawadi Party	104	0	104	0.05	KARAWAL NAGAR
13	SUNITA N. KUMAR	Peoples Party of India (Democratic)	257	0	257	0.13	KARAWAL NAGAR
14	HARISH	Mazdoor Kirayedar Vikas Party	81	0	81	0.04	KARAWAL NAGAR
15	AJAY SINGH RATHOR	Independent	206	0	206	0.11	KARAWAL NAGAR
16	MOHAN SINGH	Independent	248	0	248	0.13	KARAWAL NAGAR
17	YOGESH SWAMY	Independent	131	0	131	0.07	KARAWAL NAGAR
18	S.N. Singh	Independent	371	0	371	0.19	KARAWAL NAGAR
19	NOTA	None of the Above	370	3	373	0.2	KARAWAL NAGAR
